11111111111111
10000100000001
1010000C0X0001
1E100000000001
10100C000000P1
11111111111111