11111111111111
100X010000X001
1010000C000001
1E1000X0000001
10100C000000P1
11111111111111